NO assets/textures/snow.png
SO assets/textures/diamond.png
WE assets/textures/sand.png
EA assets/textures/grass.png

C 0,87,183
F 255,215,0

11111
10001
1E001
10001
10001
11011
10001
10001
11111
