NO assets/textures/north.png
SO assets/textures/south.png
WE assets/textures/west.png
EA assets/textures/east.png

F 0,255,0
C 0,0,255

11111
10001
10001
10001
10001
11011
10001
10N01
11111
