


map.cub rev:
11111111 1111111 111111111111
11110111 1110101 101111010001
1100000111010101111101111000111
10000000000000001101010010001
1000000000000001100000010001
110000N0110101011100000010001
11110111111111011101010010001
11110111111111011100000010001
100000000011000001110111111111111
111111111011000001110000000000001
        1001000000000000000000001
        1011000001110000000000001
        1000000000110000000000001
        1111111111111111111111111


map.cub orig:
        1111111111111111111111111
        1000000000110000000000001
        1011000001110000000000001
        1001000000000000000000001
111111111011000001110000000000001
100000000011000001110111111111111
11110111111111011100000010001
11110111111111011101010010001
110000N0110101011100000010001
1000000000000001100000010001
10000000000000001101010010001
1100000111010101111101111000111
11110111 1110101 101111010001
11111111 1111111 111111111111




map** rev:

111111112111111121111111111112
111101112111010121011110100012
11000001110101011111011110001112
100000000000000011010100100012
10000000000000011000000100012
110000001101010111000000100012
111101111111110111010100100012
111101111111110111000000100012
1000000000110000011101111111111112
1111111110110000011100000000000012
2222222210010000000000000000000012
2222222210110000011100000000000012
2222222210000000001100000000000012
2222222211111111111111111111111112

map** orig:
2222222211111111111111111111111112
2222222210000000001100000000000012
2222222210110000011100000000000012
2222222210010000000000000000000012
1111111110110000011100000000000012
1000000000110000011101111111111112
111101111111110111000000100012
111101111111110111010100100012
110000001101010111000000100012
10000000000000011000000100012
100000000000000011010100100012
11000001110101011111011110001112
111101112111010121011110100012
111111112111111121111111111112

