NO assets/textures/north.png
SO assets/textures/south.png
WE assets/textures/west.png
EA assets/textures/east.png

F 0,255,0
C 0,0,255

111111
100101
101001
1100N1
111111
